acomodate	accommodate
acknowlegment	acknowledgment
arguemint	argument
comitmant	commitment
consenssus	consensus
deductabel	deductible
depindant	dependent
embaras		embarrass
existanse	existence
forword	foreword
haras	harass
inadvartent	inadvertent
indispensible	indispensable
judgement	judgment
liaison	liaison
lisense	license
occasion	occasion
ocurrance	occurrence
perserverance	perseverance
prerogative	prerogative
procede	proceed
separete	separate
superceed	supersede
withold	withhold