Labhair	Labhair
muid	muid
le	le
James	James
Ó	Ó
Baoill	Baoill
ó	ó
faoin	faoin
bpaisean	bpaisean
,	,
faoin	faoin
spiorad	spiorad
,	,
agus	agus
faoin	faoin
gcomrádaíocht	gcomrádaíocht
a	a
bhí	bhí
acu	acu
i	i
rith	rith
na	na
bliana	bliana
Borradh	Borradh
-	-
business	business
network	network
trí	trí
Ghaeilge	Ghaeilge
.	.